13,3,3,4,1,0,0,0,0,13,3,1,1,3,-1
10,5,1,1,3,0,0,0,0,18,1,1,1,2,-1
1,9,5,12,1,0,0,0,0,4,10,5,1,4,-1
18,1,1,1,2,0,0,0,0,1,4,1,14,7,-1
16,4,3,6,8,0,0,0,0,15,1,9,6,13,-1
