13,1,1,1,15,1,6,13,18,-1
1,18,9,9,9,9,10,3,1,-1
3,9,4,14,4,14,4,10,1,-1
3,9,1,9,9,9,1,9,1,-1
8,9,1,9,16,9,5,9,3,-1
7,9,1,9,1,9,1,5,2,-1
13,2,4,14,4,14,4,1,3,-1
7,3,9,9,9,9,9,9,7,-1
1,18,1,2,8,2,4,1,8,-1
