1,13,18,1,13,16,18,-1
18,1,1,3,1,1,1,-1
1,1,3,18,1,3,1,-1
15,3,1,1,3,18,3,-1
1,18,1,3,1,1,3,-1
1,1,3,1,18,3,3,-1
18,13,1,18,1,2,14,-1
