14,9,1,5,2,3,13,-1
3,18,4,9,1,9,7,-1
1,1,1,1,1,1,1,-1
13,4,1,15,1,1,1,-1
18,1,5,10,18,1,2,-1
3,1,9,1,1,1,9,-1
16,3,1,1,4,6,13,-1
